W	W	W	W	W	W	W	W	W	W	W	W	W	W	W	W	W	W	W	W	W	W	W	W	W	W	W	W	x
W	P	P	P	P	P	P	P	P	P	P	P	P	W	W	P	P	P	P	P	P	P	P	P	P	P	P	W	x
W	P	W	W	W	W	P	W	W	W	W	W	P	W	W	P	W	W	W	W	W	P	W	W	W	W	P	W	x
W	P	W	W	W	W	P	W	W	W	W	W	P	W	W	P	W	W	W	W	W	P	W	W	W	W	P	W	x
W	P	W	W	W	W	P	W	W	W	W	W	P	W	W	P	W	W	W	W	W	P	W	W	W	W	P	W	x
W	P	P	P	P	P	P	P	P	P	P	P	P	P	P	P	P	P	P	P	P	P	P	P	P	P	P	W	x
W	P	W	W	W	W	P	W	W	P	W	W	W	W	W	W	W	W	P	W	W	P	W	W	W	W	P	W	x
W	P	W	W	W	W	P	W	W	P	W	W	W	W	W	W	W	W	P	W	W	P	W	W	W	W	P	W	x
W	P	P	P	P	P	P	W	W	P	P	P	P	W	W	P	P	P	P	W	W	P	P	P	P	P	P	W	x
W	W	W	W	W	W	P	W	W	W	W	W	A	W	W	A	W	W	W	W	W	P	W	W	W	W	W	W	x
W	W	W	W	W	W	P	W	W	W	W	W	A	W	W	A	W	W	W	W	W	P	W	W	W	W	W	W	x
W	W	W	W	W	W	P	W	W	A	A	A	A	A	A	A	A	A	A	W	W	P	W	W	W	W	W	W	x
W	W	W	W	W	W	P	W	W	A	W	W	G	G	G	G	W	W	A	W	W	P	W	W	W	W	W	W	x
W	W	W	W	W	W	P	W	W	A	W	W	W	W	W	W	W	W	A	W	W	P	W	W	W	W	W	W	x
W	W	W	W	W	W	P	W	W	A	W	W	W	W	W	W	W	W	A	W	W	P	W	W	W	W	W	W	x
A	A	A	A	A	A	P	P	P	P	P	P	P	P	P	P	P	P	P	P	P	P	A	A	A	A	A	A	x
W	W	W	W	W	W	P	W	W	A	W	W	W	W	W	W	W	W	A	W	W	P	W	W	W	W	W	W	x
W	W	W	W	W	W	P	W	W	A	W	W	W	W	W	W	W	W	A	W	W	P	W	W	W	W	W	W	x
W	W	W	W	W	W	P	W	W	A	A	A	A	S	A	A	A	A	A	W	W	P	W	W	W	W	W	W	x
W	W	W	W	W	W	P	W	W	A	W	W	W	W	W	W	W	W	A	W	W	P	W	W	W	W	W	W	x
W	W	W	W	W	W	P	W	W	A	W	W	W	W	W	W	W	W	A	W	W	P	W	W	W	W	W	W	x
W	P	P	P	P	P	P	P	P	P	P	P	P	W	W	P	P	P	P	P	P	P	P	P	P	P	P	W	x
W	P	W	W	W	W	P	W	W	W	W	W	P	W	W	P	W	W	W	W	W	P	W	W	W	W	P	W	x
W	P	W	W	W	W	P	W	W	W	W	W	P	W	W	P	W	W	W	W	W	P	W	W	W	W	P	W	x
W	P	P	P	W	W	P	P	P	P	P	P	P	P	P	P	P	P	P	P	P	P	W	W	P	P	P	W	x
W	W	W	P	W	W	P	W	W	P	W	W	G	G	G	G	W	W	P	W	W	P	W	W	P	W	W	W	x
W	W	W	P	W	W	P	W	W	P	W	W	W	W	W	W	W	W	P	W	W	P	W	W	P	W	W	W	x
W	P	P	P	P	P	P	W	W	P	P	P	P	W	W	P	P	P	P	W	W	P	P	P	P	P	P	W	x
W	P	W	W	W	W	W	W	W	W	W	W	P	W	W	P	W	W	W	W	W	W	W	W	W	W	P	W	x
W	P	W	W	W	W	W	W	W	W	W	W	P	W	W	P	W	W	W	W	W	W	W	W	W	W	P	W	x
W	P	P	P	P	P	P	P	P	P	P	P	P	P	P	P	P	P	P	P	P	P	P	P	P	P	P	W	x
W	W	W	W	W	W	W	W	W	W	W	W	W	W	W	W	W	W	W	W	W	W	W	W	W	W	W	W	x
